






SO ./path_to_the_south_texture     
WE ./path_to_the_west_texture    
NO ./path_to_the_north_texture

EA         ./path_to_the_east_texture




      F   220,  100,0


C 225  ,30  ,0

1111a111    1   
1000N001
1111111 1    1