NO                ../north.xpm








SO       ../south.xpm
WE ../west.xpm



EA               ../east.xpm

F 220      ,      100,      0



C                225,             30,0

                   11111111111111111111                        
111111111111111111100000000000000000000111111111111111111
100000001111110000000000000000000000000000000000001100001
111110000000000000000000000001010101010110101010101100001     11111
10000000000010101101010101010110101010101011011000000000111111000001
10000000000000000000000000000000000000000000000000000000000000000001
1000000N000000000000000000001111111111111111110000000000000000000001
10000000000000000000000000001                10000011111111111111111
1000000000000000000000000000111111111111111111000001
1111111111111111111111111110000000000000000000000001
                           1111111111111111111111111