NO                ../north.xpm



SO       ../south.xpm
WE ../west.xpm

EA               ../east.xpm

F 220         ,       100 , 0       

C            225,          30,0      

11111111
10000001
10101N01
11101111
11000011
10000001
11011011
 111111 