NO images/Dungeon_brick_wall_blue.xpm
SO images/Dungeon_brick_wall_grey.xpm
WE images/Dungeon_brick_wall_yellow.xpm
EA images/Dungeon_brick_wall_purple.xpm

F 220, 100, 0
C 225, 30, 0

        1111111111111111111111111
        1000000000110000000000001
        1011000001110000000000001
        2001000000000000000000001
111111111011000001110000000000001
100000000011000001110111112111111
11110111111111011100000010001
11110111111111011101010010001
11000000110101011100000010001
10000000000000001100000020N01
10000000000000001101010010001
1100000111010101111101111000111
11110111 1110101 101111010001
11111111 1111111 111111111111