NO images/north.xpm
SO images/south.xpm
WE images/west.xpm
EA images/east.xpm

F 220, 100, 0
C 225, 30, 0

1111111111111111111111111111111
1000000000000000000000000000001
1000000000000000000000000000001
1000111111100000000001111110001
10001     100100001000    10001
10100111110010100101001111000001111111
10000100010000000000000000000000000001
1000000000000101N101011010101101010111
11111111111111111111111111111111111