NO images/Dungeon_brick_wall_blue.xpm
SO images/Dungeon_brick_wall_grey.xpm
WE images/Dungeon_brick_wall_yellow.xpm
EA images/Dungeon_brick_wall_purple.xpm

F 100, 100, 0

C 100, 30, 0

111111111111111111111111111111111111111111111
100000000000000000000000000000000000000000001
10000000000000000000000000000000000000000S001
111111111000000000000000000000000000000000001
        1000000000011111111111000000000000001
        100000000001         1000000011111001
        111110001111         1111000011001001
        1000000000011111111110000000001011001
111111110000000000000000000000000000000010101
100000000001111100000011100000000010101010101
111111111111111111111111111111111111111111111