NO images/Dungeon_brick_wall_blue.xpm
SO images/Dungeon_brick_wall_grey.xpm
WE images/Dungeon_brick_wall_yellow.xpm
EA images/Dungeon_brick_wall_purple.xpm

F 220, 100, 0
C 225, 30, 0

111111111111111
100000000000001
10N011110000001
100000000000001111
111110000010000001
    10000010001001
    10000010000001
111110001000001111
10000000110001
10000000000001
11111111111111