NO images/Dungeon_brick_wall_blue.xpm
SO images/Dungeon_brick_wall_grey.xpm
WE images/Dungeon_brick_wall_yellow.xpm
EA images/Dungeon_brick_wall_purple.xpm

F 100, 100, 0

C 100, 30, 0

1111111111111111111111111
1000000000011110000001001
1011011111000011101100011
1001000011011000001101111
1110111011001111111100111
1100000001101110000110001
1001110111101000110111101
1011000001100011110101101
1001011100011100010101101
11110011011N0101000101001
1111101100010101111001011
1000000011000000100011011
1100011011111110100000011
1001100000000011101111111
1011100000011001100111001
1011100000011111110000101
1000001111000000000110001
1111111111111111111111111